
111111111111111111111111111
1P1000001001010C00001111C11
10001010000000011110C111011
1111101111111111C111C111001
1C0110100011111000011111101
1100000010000000110000000E1
111111111111111111111111111
